############# ##########
# S# S#   #    S#   # S#
#  # ###  #  ####   # ##
#  #  #   #    #    #  #
#                      #
#######   ####   #### ##
#S   #      #      #   #
##   ###    #S     #  S#
#           ####   #####
#######  ########  #####
# S  #       #       ###
#            #     ###S#
#########    ###   ##  #
# S  #              #  #
#    #      ####       #
## ###      #  #    ####
#            P         #
#S  ####    #  #     ###
#           ####      S#
#        ###########   #
### ### ########      ##
#    #    #       #   ##
#    #    #   #   #    #
##################### ##