##########
#    P   #
#  S     #
#      S #
#      S #
#      S #
#      S #
#      S #
#      S #
##########        